aai -> Arifama-Miniafia
aak -> Ankave
aau -> Abau
aaz -> Amarasi
aba -> Abé
abi -> Abidji
abk -> Abkhazian
abn -> Abua
abq -> Abaza
abs -> Ambonese Malay
abt -> Ambulas
abx -> Inabaknon
aby -> Aneme Wake
abz -> Abui
aca -> Achagua
acd -> Gikyode
ace -> Achinese
acf -> Saint Lucian Creole French
ach -> Acoli
acm -> Mesopotamian Arabic
acn -> Achang
acr -> Achi
acu -> Achuar-Shiwiar
ada -> Adangme
ade -> Adele
adh -> Adhola
adi -> Adi
adj -> Adioukrou
adl -> Galo
ady -> Adyghe
adz -> Adzera
aeb -> Tunisian Arabic
aer -> Eastern Arrernte
aeu -> Akeu
aey -> Amele
afb -> Gulf Arabic
afr -> Afrikaans
agd -> Agarabi
agg -> Angor
agm -> Angaataha
agn -> Agutaynen
agr -> Aguaruna
agt -> Central Cagayan Agta
agu -> Aguacateco
agw -> Kahua
agx -> Aghul
aha -> Ahanta
ahk -> Akha
ahr -> Ahirani
aia -> Arosi
aii -> Assyrian Neo-Aramaic
aim -> Aimol
ain -> Ainu (Japan)
ajg -> Aja (Benin)
aji -> Ajië
ajp -> South Levantine Arabic
ajz -> Amri Karbi
akb -> Batak Angkola
ake -> Akawaio
akh -> Angal Heneng
akl -> Aklanon
akp -> Siwu
ald -> Alladian
alj -> Alangan
aln -> Gheg Albanian
alp -> Alune
alq -> Algonquin
als -> Tosk Albanian
alt -> Southern Altai
aly -> Alyawarr
alz -> Alur
ame -> Yanesha'
amf -> Hamer-Banna
amh -> Amharic
ami -> Amis
amk -> Ambai
amm -> Ama (Papua New Guinea)
amn -> Amanab
amp -> Alamblak
amr -> Amarakaeri
amu -> Guerrero Amuzgo
amx -> Anmatyerre
ang -> Old English (ca. 450-1100)
anm -> Anal
ann -> Obolo
anp -> Angika
anv -> Denya
any -> Anyin
aoi -> Anindilyakwa
aoj -> Mufian
aom -> Ömie
aoz -> Uab Meto
apb -> Sa'a
apc -> North Levantine Arabic
apd -> Sudanese Arabic
ape -> Bukiyip
apn -> Apinayé
apr -> Arop-Lokep
apt -> Apatani
apu -> Apurinã
apw -> Western Apache
apy -> Apalaí
apz -> Safeyoka
aqz -> Akuntsu
ara -> Arabic
arb -> Standard Arabic
arc -> Official Aramaic (700-300 BCE)
are -> Western Arrarnta
arg -> Aragonese
arl -> Arabela
arn -> Mapudungun
arp -> Arapaho
arq -> Algerian Arabic
arr -> Karo (Brazil)
ars -> Najdi Arabic
ary -> Moroccan Arabic
arz -> Egyptian Arabic
asg -> Cishingini
asm -> Assamese
aso -> Dano
ast -> Asturian
ata -> Pele-Ata
atb -> Zaiwa
atd -> Ata Manobo
atg -> Ivbie North-Okpela-Arhe
ati -> Attié
atj -> Atikamekw
atq -> Aralle-Tabulahan
att -> Pamplona Atta
auc -> Waorani
aui -> Anuki
auy -> Awiyaana
ava -> Avaric
avk -> Kotava
avn -> Avatime
avt -> Au
avu -> Avokaya
awa -> Awadhi
awb -> Awa (Papua New Guinea)
awi -> Aekyom
awx -> Awara
ayl -> Libyan Arabic
ayo -> Ayoreo
ayp -> North Mesopotamian Arabic
ayr -> Central Aymara
azb -> South Azerbaijani
azg -> San Pedro Amuzgos Amuzgo
azj -> North Azerbaijani
azz -> Highland Puebla Nahuatl
bak -> Bashkir
bal -> Baluchi
bam -> Bambara
ban -> Balinese
bao -> Waimaha
bar -> Bavarian
bas -> Basa (Cameroon)
bav -> Vengo
bba -> Baatonum
bbb -> Barai
bbc -> Batak Toba
bbj -> Ghomálá'
bbk -> Babanki
bbo -> Northern Bobo Madaré
bbr -> Girawa
bcc -> Southern Balochi
bch -> Bariai
bci -> Baoulé
bcl -> Central Bikol
bco -> Kaluli
bcw -> Bana
bdd -> Bunama
bdh -> Baka (South Sudan)
bdq -> Bahnar
bdv -> Bodo Parja
bea -> Beaver
bef -> Benabena
bel -> Belarusian
bem -> Bemba (Zambia)
ben -> Bengali
beq -> Beembe
ber
bew -> Betawi
bex -> Jur Modo
bfd -> Bafut
bfo -> Malba Birifor
bfq -> Badaga
bfy -> Bagheli
bfz -> Mahasu Pahari
bgc -> Haryanvi
bgq -> Bagri
bgr -> Bawm Chin
bgs -> Tagabawa
bgt -> Bughotu
bgz -> Banggai
bh
bhd -> Bhadrawahi
bhg -> Binandere
bhl -> Bimin
bho -> Bhojpuri
bhp -> Bima
bht -> Bhattiyali
bhw -> Biak
bhz -> Bada (Indonesia)
bib -> Bissa
big -> Biangai
bim -> Bimoba
bin -> Bini
bis -> Bislama
biu -> Biete
biv -> Southern Birifor
bjn -> Banjar
bjp -> Fanamaket
bjr -> Binumarien
bjv -> Bedjond
bkd -> Binukid
bkl -> Berik
bkq -> Bakairí
bku -> Buhid
bkv -> Bekwarra
bla -> Siksika
blh -> Kuwaa
blk -> Pa'o Karen
blt -> Tai Dam
blw -> Balangao
blz -> Balantak
bmh -> Kein
bmk -> Ghayavi
bmq -> Bomu
bmr -> Muinane
bmu -> Somba-Siawari
bmv -> Bum
bnj -> Eastern Tawbuid
bno -> Bantoanon
bnp -> Bola
bns -> Bundeli
boa -> Bora
bod -> Tibetan
boj -> Anjam
bom -> Berom
bon -> Bine
bor -> Borôro
bos -> Bosnian
bov -> Tuwuli
box -> Buamu
bpr -> Koronadal Blaan
bps -> Sarangani Blaan
bpx -> Palya Bareli
bpy -> Bishnupriya
bqc -> Boko (Benin)
bqj -> Bandial
bqp -> Busa
bra -> Braj
bre -> Breton
brh -> Brahui
bru -> Eastern Bru
brx -> Bodo (India)
bsc -> Bassari
bsn -> Barasana-Eduria
bsp -> Baga Sitemu
bsq -> Bassa
bss -> Akoose
btd -> Batak Dairi
bth -> Biatah Bidayuh
bts -> Batak Simalungun
btt -> Bete-Bendi
btx -> Batak Karo
bua -> Buriat
bud -> Ntcham
bug -> Buginese
buk -> Bugawac
bul -> Bulgarian
bum -> Bulu (Cameroon)
bus -> Bokobaru
bvc -> Baelelea
bvd -> Baeggu
bvr -> Burarra
bvz -> Bauzi
bwd -> Bwaidoka
bwi -> Baniwa
bwq -> Southern Bobo Madaré
bwu -> Buli (Ghana)
bxh -> Buhutu
bxr -> Russia Buriat
byr -> Baruya
byv -> Medumba
byx -> Qaqet
bzd -> Bribri
bzh -> Mapos Buang
bzi -> Bisu
bzj -> Belize Kriol English
bzt -> Brithenig
caa -> Chortí
cab -> Garifuna
cac -> Chuj
caf -> Southern Carrier
cag -> Nivaclé
cak -> Kaqchikel
cao -> Chácobo
cap -> Chipaya
caq -> Car Nicobarese
car -> Galibi Carib
cas -> Tsimané
cat -> Catalan
cav -> Cavineña
cax -> Chiquitano
cbc -> Carapana
cbi -> Chachi
cbk -> Chavacano
cbr -> Cashibo-Cacataibo
cbs -> Cashinahua
cbt -> Chayahuita
cbu -> Candoshi-Shapra
cbv -> Cacua
cce -> Chopi
cco -> Comaltepec Chinantec
ccp -> Chakma
cdf -> Chiru
cdo -> Min Dong Chinese
ceb -> Cebuano
ceg -> Chamacoco
cek -> Eastern Khumi Chin
ces -> Czech
cfm -> Falam Chin
cgc -> Kagayanen
cgg -> Chiga
cha -> Chamorro
chd -> Highland Oaxaca Chontal
che -> Chechen
chf -> Tabasco Chontal
chg -> Chagatai
chj -> Ojitlán Chinantec
chk -> Chuukese
chm -> Mari (Russia)
cho -> Choctaw
chq -> Quiotepec Chinantec
chr -> Cherokee
chu -> Church Slavic
chv -> Chuvash
chw -> Chuwabu
chz -> Ozumacín Chinantec
cjk -> Chokwe
cjo -> Ashéninka Pajonal
cjp -> Cabécar
cjs -> Shor
cjv -> Chuave
cjy -> Jinyu Chinese
ckb -> Central Kurdish
ckm -> Chakavian
cko -> Anufo
ckt -> Chukot
cle -> Lealao Chinantec
clu -> Caluyanun
cly -> Eastern Highland Chatino
cme -> Cerma
cmn -> Mandarin Chinese
cmo -> Central Mnong
cmr -> Mro-Khimi Chin
cnh -> Hakha Chin
cni -> Asháninka
cnk -> Khumi Chin
cnl -> Lalana Chinantec
cnr -> Montenegrin
cnt -> Tepetotutla Chinantec
cnw -> Ngawn Chin
coe -> Koreguaje
cof -> Colorado
cok -> Santa Teresa Cora
con -> Cofán
cop -> Coptic
cor -> Cornish
cos -> Corsican
cot -> Caquinte
cou -> Wamey
cpa -> Palantla Chinantec
cpb -> Ucayali-Yurúa Ashéninka
cpc -> Ajyíninka Apurucayali
cpu -> Pichis Ashéninka
cpy -> South Ucayali Ashéninka
cre -> Cree
crh -> Crimean Tatar
cri -> Sãotomense
crj -> Southern East Cree
crk -> Plains Cree
crl -> Northern East Cree
crm -> Moose Cree
crn -> El Nayar Cora
crs -> Seselwa Creole French
crt -> Iyojwa'ja Chorote
crx -> Carrier
csb -> Kashubian
csk -> Jola-Kasa
cso -> Sochiapam Chinantec
csw -> Swampy Cree
csy -> Siyin Chin
cta -> Tataltepec Chatino
ctd -> Tedim Chin
ctg -> Chittagonian
cto -> Emberá-Catío
ctp -> Western Highland Chatino
ctu -> Chol
cub -> Cubeo
cuc -> Usila Chinantec
cui -> Cuiba
cuk -> San Blas Kuna
cul -> Culina
cut -> Teutila Cuicatec
cux -> Tepeuxila Cuicatec
cwd -> Woods Cree
cwe -> Kwere
cwt -> Kuwaataay
cya -> Nopala Chatino
cym -> Welsh
czt -> Zotung Chin
daa -> Dangaléat
dad -> Marik
daf
dag -> Dagbani
dah -> Gwahatike
dak -> Dakota
dan -> Danish
dar -> Dargwa
dbq -> Daba
ddg -> Fataluku
ddn -> Dendi (Benin)
ded -> Dedua
des -> Desano
deu -> German
dga -> Southern Dagaare
dgc -> Casiguran Dumagat Agta
dgi -> Northern Dagara
dgr -> Dogrib
dgz -> Daga
dhd -> Dhundari
dhg -> Dhangu-Djangu
dhm -> Zemba
dhv -> Dehu
did -> Didinga
dig -> Digo
dik -> Southwestern Dinka
din -> Dinka
dip -> Northeastern Dinka
diq -> Dimli (individual language)
dis -> Dimasa
diu -> Diriku
div -> Dhivehi
dje -> Zarma
djk -> Eastern Maroon Creole
djr -> Djambarrpuyngu
dks -> Southeastern Dinka
dln -> Darlong
dng -> Dungan
dnj -> Dan
dnw -> Western Dani
dob -> Dobu
doi -> Dogri (macrolanguage)
dop -> Lukpa
dos -> Dogosé
dow -> Doyayo
drg -> Rungus
dru -> Rukai
dsb -> Lower Sorbian
dsh -> Daasanach
dso -> Desiya
dtb -> Labuk-Kinabatangan Kadazan
dtp -> Kadazan Dusun
dts -> Toro So Dogon
dty -> Dotyali
dua -> Duala
due -> Umiray Dumaget Agta
dug -> Duruma
duo -> Dupaninan Agta
dur -> Dii
dwr -> Dawro
dww -> Dawawa
dyi -> Djimini Senoufo
dyo -> Jola-Fonyi
dyu -> Dyula
dzo -> Dzongkha
ebk -> Eastern Bontok
efi -> Efik
eka -> Ekajuk
ekk -> Standard Estonian
eko -> Koti
ell -> Modern Greek (1453-)
eme -> Emerillon
emi -> Mussau-Emira
eml
emp -> Northern Emberá
enb -> Markweeta
eng -> English
enl -> Enlhet
enm -> Middle English (1100-1500)
enq -> Enga
enx -> Enxet
epo -> Esperanto
eri -> Ogea
ese -> Ese Ejja
esi -> North Alaskan Inupiatun
esk -> Northwest Alaska Inupiatun
ess -> Central Siberian Yupik
esu -> Central Yupik
eto -> Eton (Cameroon)
etr -> Edolo
etu -> Ejagham
eus -> Basque
eve -> Even
evn -> Evenki
ewe -> Ewe
ewo -> Ewondo
ext -> Extremaduran
eza -> Ezaa
faa -> Fasu
fad -> Wagi
fai -> Faiwol
fal -> South Fali
fan -> Fang (Equatorial Guinea)
fao -> Faroese
far -> Fataleka
fas -> Persian
fat -> Fanti
ffm -> Maasina Fulfulde
fij -> Fijian
fil -> Filipino
fin -> Finnish
fit -> Tornedalen Finnish
fkv -> Kven Finnish
fmu -> Far Western Muria
fon -> Fon
for -> Fore
fra -> French
frd -> Fordata
fro -> Old French (842-ca. 1400)
frp -> Arpitan
frr -> Northern Frisian
fry -> Western Frisian
fub -> Adamawa Fulfulde
fud -> East Futuna
fue -> Borgu Fulfulde
fuf -> Pular
fuh -> Western Niger Fulfulde
ful -> Fulah
fuq -> Central-Eastern Niger Fulfulde
fur -> Friulian
fuv -> Nigerian Fulfulde
gaa -> Ga
gag -> Gagauz
gah -> Alekano
gai -> Borei
gam -> Kandawo
gan -> Gan Chinese
gaq -> Gata'
gaw -> Nobonob
gaz -> West Central Oromo
gbi -> Galela
gbm -> Garhwali
gbo -> Northern Grebo
gbr -> Gbagyi
gcf -> Guadeloupean Creole French
gcr -> Guianese Creole French
gde -> Gude
gdg -> Ga'dang
gdn -> Umanakaina
gdr -> Wipi
geb -> Kire
gej -> Gen
gfk -> Patpatar
ghe -> Southern Ghale
ghs -> Guhu-Samane
gid -> Gidar
gil -> Gilbertese
giz -> South Giziga
gjn -> Gonja
gkn -> Gokana
gla -> Scottish Gaelic
gle -> Irish
glg -> Galician
glk -> Gilaki
glv -> Manx
gmh -> Middle High German (ca. 1050-1500)
gmv -> Gamo
gna -> Kaansa
gnb -> Gangte
gnd -> Zulgo-Gemzek
gng -> Ngangam
gnn -> Gumatj
gnw -> Western Bolivian Guaraní
goa -> Guro
gof -> Gofa
gog -> Gogo
goh -> Old High German (ca. 750-1050)
gom -> Goan Konkani
gor -> Gorontalo
gos -> Gronings
got -> Gothic
gqr -> Gor
grc -> Ancient Greek (to 1453)
grt -> Garo
gso -> Southwest Gbaya
gsw -> Swiss German
gub -> Guajajára
guc -> Wayuu
gud -> Yocoboué Dida
gug -> Paraguayan Guaraní
guh -> Guahibo
gui -> Eastern Bolivian Guaraní
guj -> Gujarati
guk -> Gumuz
gul -> Sea Island Creole English
gum -> Guambiano
gun -> Mbyá Guaraní
guo -> Guayabero
guq -> Aché
gur -> Farefare
guu -> Yanomamö
guw -> Gun
gux -> Gourmanchéma
guz -> Gusii
gvc -> Guanano
gvf -> Golin
gvl -> Gulay
gvn -> Kuku-Yalanji
gwi -> Gwichʼin
gwr -> Gwere
gya -> Northwest Gbaya
gym -> Ngäbere
gyr -> Guarayu
hac -> Gurani
hae -> Eastern Oromo
hag -> Hanga
hak -> Hakka Chinese
hat -> Haitian
hau -> Hausa
hav -> Havu
haw -> Hawaiian
hay -> Haya
hbo -> Ancient Hebrew
hch -> Huichol
heb -> Hebrew
heg -> Helong
heh -> Hehe
her -> Herero
hif -> Fiji Hindi
hig -> Kamwe
hil -> Hiligaynon
hin -> Hindi
hix -> Hixkaryána
hla -> Halia
hlt -> Matu Chin
hmo -> Hiri Motu
hmr -> Hmar
hne -> Chhattisgarhi
hnj -> Hmong Njua
hnn -> Hanunoo
hns -> Caribbean Hindustani
hoc -> Ho
hop -> Hopi
hot -> Hote
hoy -> Holiya
hra -> Hrangkhol
hrv -> Croatian
hrx -> Hunsrik
hsb -> Upper Sorbian
hsn -> Xiang Chinese
hto -> Minica Huitoto
hub -> Huambisa
hui -> Huli
hun -> Hungarian
hus -> Huastec
huu -> Murui Huitoto
huv -> San Mateo Del Mar Huave
hvn -> Sabu
hwc -> Hawai'i Creole English
hye -> Armenian
hyw -> Western Armenian
ian -> Iatmul
iba -> Iban
ibg -> Ibanag
ibo -> Igbo
icr -> Islander Creole English
ido -> Ido
idu -> Idoma
ifa -> Amganad Ifugao
ifb -> Batad Ifugao
ife -> Ifè
ifk -> Tuwali Ifugao
ifu -> Mayoyao Ifugao
ify -> Keley-I Kallahan
ige -> Igede
ign -> Ignaciano
iii -> Sichuan Yi
ike -> Eastern Canadian Inuktitut
ikk -> Ika
ikt -> Inuinnaqtun
iku -> Inuktitut
ikw -> Ikwere
ilb -> Ila
ile -> Interlingue
ilo -> Iloko
imo -> Imbongu
ina -> Interlingua (International Auxiliary Language Association)
inb -> Inga
ind -> Indonesian
inh -> Ingush
ino -> Inoke-Yate
iou -> Tuma-Irumu
ipi -> Ipili
iqw -> Ikwo
iri -> Rigwe
irk -> Iraqw
iry -> Iraya
isd -> Isnag
ish -> Esan
isl -> Icelandic
iso -> Isoko
ita -> Italian
itl -> Itelmen
itv -> Itawit
ium -> Iu Mien
ivb -> Ibatan
ivv -> Ivatan
iws -> Sepik Iwam
ixl -> Ixil
izr -> Izere
izz -> Izii
jaa -> Jamamadí
jac -> Popti'
jae -> Yabem
jam -> Jamaican Creole English
jav -> Javanese
jbo -> Lojban
jbu -> Jukun Takum
jdt -> Judeo-Tat
jic -> Tol
jiv -> Shuar
jmc -> Machame
jpa -> Jewish Palestinian Aramaic
jpn -> Japanese
jra -> Jarai
jun -> Juang
juy -> Juray
jvn -> Caribbean Javanese
kaa -> Kara-Kalpak
kab -> Kabyle
kac -> Kachin
kak -> Kalanguya
kal -> Kalaallisut
kam -> Kamba (Kenya)
kan -> Kannada
kao -> Xaasongaxango
kap -> Bezhta
kaq -> Capanahua
kas -> Kashmiri
kat -> Georgian
kaz -> Kazakh
kbc -> Kadiwéu
kbd -> Kabardian
kbh -> Camsá
kbm -> Iwal
kbo -> Keliko
kbp -> Kabiyè
kbq -> Kamano
kbr -> Kafa
kby -> Manga Kanuri
kca -> Khanty
kcg -> Tyap
kck -> Kalanga
kdc -> Kutu
kde -> Makonde
kdh -> Tem
kdi -> Kumam
kdj -> Karamojong
kdl -> Tsikimba
kdp -> Kaningdon-Nindem
kdr -> Karaim
kea -> Kabuverdianu
kei -> Kei
kek -> Kekchí
ken -> Kenyang
keo -> Kakwa
ker -> Kera
kew -> West Kewa
kex -> Kukna
kez -> Kukele
kff -> Koya
kfy -> Kumaoni
kgf -> Kube
kgk -> Kaiwá
kgp -> Kaingang
kgr -> Abun
kha -> Khasi
khk -> Halh Mongolian
khm -> Khmer
khq -> Koyra Chiini Songhay
khs -> Kasua
khy -> Kele (Democratic Republic of Congo)
khz -> Keapara
kia -> Kim
kij -> Kilivila
kik -> Kikuyu
kin -> Kinyarwanda
kir -> Kirghiz
kiu -> Kirmanjki (individual language)
kix -> Khiamniungan Naga
kjb -> Q'anjob'al
kje -> Kisar
kjh -> Khakas
kjs -> East Kewa
kkc -> Odoodee
kki -> Kagulu
kkj -> Kako
kkl -> Kosarek Yale
kle -> Kulung (Nepal)
klj -> Khalaj
klt -> Nukna
klv -> Maskelynes
kma -> Konni
kmb -> Kimbundu
kmd -> Majukayang Kalinga
kmg -> Kâte
kmh -> Kalam
kmk -> Limos Kalinga
kmm -> Kom (India)
kmo -> Kwoma
kmr -> Northern Kurdish
kms -> Kamasau
kmu -> Kanite
kmy -> Koma
knc -> Central Kanuri
kne -> Kankanaey
knf -> Mankanya
kng -> Koongo
knj -> Western Kanjobal
knk -> Kuranko
kno -> Kono (Sierra Leone)
knv -> Tabo
knx -> Kendayan
kny -> Kanyok
kog -> Cogui
koi -> Komi-Permyak
kom -> Komi
koo -> Konzo
kor -> Korean
kos -> Kosraean
kpe -> Kpelle
kpf -> Komba
kpg -> Kapingamarangi
kpj -> Karajá
kpq -> Korupun-Sela
kpr -> Korafe-Yegha
kpv -> Komi-Zyrian
kpw -> Kobon
kpx -> Mountain Koiali
kpz -> Kupsabiny
kqa -> Mum
kqc -> Doromu-Koki
kqe -> Kalagan
kqf -> Kakabai
kql -> Kyenele
kqn -> Kaonde
kqo -> Eastern Krahn
kqp -> Kimré
kqs -> Northern Kissi
kqw -> Kandas
kqy -> Koorete
krc -> Karachay-Balkar
kri -> Krio
krj -> Kinaray-A
krl -> Karelian
kru -> Kurukh
krx -> Karon
ksb -> Shambala
ksc -> Southern Kalinga
ksd -> Kuanua
ksf -> Bafia
ksh -> Kölsch
ksj -> Uare
ksp -> Kaba
ksr -> Borong
kss -> Southern Kisi
ksw -> S'gaw Karen
ktb -> Kambaata
ktj -> Plapo Krumen
ktm -> Kurti
kto -> Kuot
ktu -> Kituba (Democratic Republic of Congo)
ktz -> Juǀʼhoan
kua -> Kuanyama
kub -> Kutep
kud -> 'Auhelawa
kue -> Kuman (Papua New Guinea)
kuj -> Kuria
kum -> Kumyk
kup -> Kunimaipa
kus -> Kusaal
kvg -> Kuni-Boazi
kvj -> Psikye
kvn -> Border Kuna
kwd -> Kwaio
kwf -> Kwara'ae
kwi -> Awa-Cuaiquer
kwj -> Kwanga
kwn -> Kwangali
kwy -> San Salvador Kongo
kxc -> Konso
kxm -> Northern Khmer
kxv -> Kuvi
kxw -> Konai
kyc -> Kyaka
kyf -> Kouya
kyg -> Keyagana
kyq -> Kenga
kyu -> Western Kayah
kyz -> Kayabí
kze -> Kosena
kzf -> Da'a Kaili
kzj
kzn -> Kokola
lac -> Lacandon
lad -> Ladino
lai -> Lambya
laj -> Lango (Uganda)
lam -> Lamba
lao -> Lao
lap -> Laka (Chad)
las -> Lama (Togo)
lat -> Latin
law -> Lauje
lbb -> Label
lbe -> Lak
lbj -> Ladakhi
lbk -> Central Bontok
lbm -> Lodhi
lcm -> Tungag
lcp -> Western Lawa
ldi -> Laari
ldn -> Láadan
lea -> Lega-Shabunda
led -> Lendu
lee -> Lyélé
lef -> Lelemi
leh -> Lenje
lem -> Nomaande
lep -> Lepcha
leu -> Kara (Papua New Guinea)
lew -> Ledo Kaili
lex -> Luang
lez -> Lezghian
lfn -> Lingua Franca Nova
lgg -> Lugbara
lgl -> Wala
lgm -> Lega-Mwenga
lhi -> Lahu Shi
lhu -> Lahu
lia -> West-Central Limba
lid -> Nyindrou
lif -> Limbu
lij -> Ligurian
lim -> Limburgan
lin -> Lingala
lip -> Sekpele
lis -> Lisu
lit -> Lithuanian
liv -> Liv
ljp -> Lampung Api
lki -> Laki
llb -> Lolo
lld -> Ladin
llg -> Lole
lln -> Lele (Chad)
lmk -> Lamkang
lmo -> Lombard
lmp -> Limbum
lnd -> Lundayeh
lob -> Lobi
loe -> Saluan
log -> Logo
lok -> Loko
lol -> Mongo
lom -> Loma (Liberia)
loq -> Lobala
loz -> Lozi
lrc -> Northern Luri
lsi -> Lashi
lsm -> Saamia
ltg -> Latgalian
ltz -> Luxembourgish
lua -> Luba-Lulua
lub -> Luba-Katanga
luc -> Aringa
lud -> Ludian
lue -> Luvale
lug -> Ganda
lun -> Lunda
luo -> Luo (Kenya and Tanzania)
lus -> Lushai
lvs -> Standard Latvian
lwg -> Wanga
lwo -> Luwo
lww -> Lewo
lzh -> Literary Chinese
lzz -> Laz
maa -> San Jerónimo Tecóatl Mazatec
mad -> Madurese
maf -> Mafa
mag -> Magahi
mah -> Marshallese
mai -> Maithili
maj -> Jalapa De Díaz Mazatec
mak -> Makasar
mal -> Malayalam
mam -> Mam
maq -> Chiquihuitlán Mazatec
mar -> Marathi
mas -> Masai
mau -> Huautla Mazatec
mav -> Sateré-Mawé
maw -> Mampruli
max -> North Moluccan Malay
maz -> Central Mazahua
mbb -> Western Bukidnon Manobo
mbc -> Macushi
mbd -> Dibabawon Manobo
mbf -> Baba Malay
mbh -> Mangseng
mbi -> Ilianen Manobo
mbj -> Nadëb
mbl -> Maxakalí
mbs -> Sarangani Manobo
mbt -> Matigsalug Manobo
mca -> Maca
mcb -> Machiguenga
mcd -> Sharanahua
mcf -> Matsés
mck -> Mbunda
mcn -> Masana
mco -> Coatlán Mixe
mcp -> Makaa
mcq -> Ese
mcu -> Cameroon Mambila
mda -> Mada (Nigeria)
mdf -> Moksha
mdy -> Male (Ethiopia)
med -> Melpa
mee -> Mengen
mej -> Meyah
mek -> Mekeo
men -> Mende (Sierra Leone)
meq -> Merey
mer -> Meru
met -> Mato
meu -> Motu
mev -> Mano
mfe -> Morisyen
mfg -> Mogofin
mfh -> Matal
mfi -> Wandala
mfk -> North Mofu
mfq -> Moba
mfy -> Mayo
mfz -> Mabaan
mgc -> Morokodo
mgh -> Makhuwa-Meetto
mgm -> Mambae
mgo -> Meta'
mgr -> Mambwe-Lungu
mhi -> Ma'di
mhl -> Mauwake
mhr -> Eastern Mari
mhw -> Mbukushu
mhx -> Maru
mhy -> Ma'anyan
mib -> Atatláhuca Mixtec
mic -> Mi'kmaq
mie -> Ocotepec Mixtec
mif -> Mofu-Gudur
mig -> San Miguel El Grande Mixtec
mih -> Chayuco Mixtec
mil -> Peñoles Mixtec
mim -> Alacatlatzala Mixtec
min -> Minangkabau
mio -> Pinotepa Nacional Mixtec
mip -> Apasco-Apoala Mixtec
miq -> Mískito
mir -> Isthmus Mixe
mit -> Southern Puebla Mixtec
miy -> Ayutla Mixtec
miz -> Coatzospan Mixtec
mjc -> San Juan Colorado Mixtec
mjl -> Mandeali
mjw -> Karbi
mkd -> Macedonian
mkl -> Mokole
mkn -> Kupang Malay
mks -> Silacayoapan Mixtec
mkz -> Makasae
mlh -> Mape
mlp -> Bargam
mlt -> Maltese
mlu -> To'abaita
mmn -> Mamanwa
mmo -> Mangga Buang
mmx -> Madak
mna -> Mbula
mnb -> Muna
mnc -> Manchu
mnf -> Mundani
mni -> Manipuri
mnk -> Mandinka
mns -> Mansi
mnw -> Mon
mnx -> Manikion
mny -> Manyawa
moa -> Mwan
moc -> Mocoví
mog -> Mongondow
moh -> Mohawk
mon -> Mongolian
mop -> Mopán Maya
mor -> Moro
mos -> Mossi
mox -> Molima
mpg -> Marba
mph -> Maung
mpm -> Yosondúa Mixtec
mpp -> Migabac
mps -> Dadibi
mpt -> Mian
mpx -> Misima-Panaeati
mqb -> Mbuko
mqj -> Mamasa
mqy -> Manggarai
mrg -> Mising
mri -> Maori
mrj -> Western Mari
mrq -> North Marquesan
mrv -> Mangareva
mrw -> Maranao
msa -> Malay (macrolanguage)
msb -> Masbatenyo
msc -> Sankaran Maninka
mse -> Musey
msk -> Mansaka
msm -> Agusan Manobo
msy -> Aruamu
mta -> Cotabato Manobo
mtg -> Una
mti -> Maiwa (Papua New Guinea)
mtj -> Moskona
mto -> Totontepec Mixe
mtp -> Wichí Lhamtés Nocten
mtr -> Mewari
mua -> Mundang
mug -> Musgu
muh -> Mündü
mui -> Musi
mup -> Malvi
mur -> Murle
mus -> Creek
mux -> Bo-Ung
muy -> Muyang
mva -> Manam
mvn -> Minaveha
mvp -> Duri
mwc -> Are
mwf -> Murrinh-Patha
mwl -> Mirandese
mwm -> Sar
mwn -> Nyamwanga
mwp -> Kala Lagaw Ya
mwq -> Mün Chin
mwr -> Marwari
mwv -> Mentawai
mww -> Hmong Daw
mxb -> Tezoatlán Mixtec
mxp -> Tlahuitoltepec Mixe
mxq -> Juquila Mixe
mxt -> Jamiltepec Mixtec
mxv -> Metlatónoc Mixtec
mya -> Burmese
myb -> Mbay
myk -> Mamara Senoufo
myu -> Mundurukú
myv -> Erzya
myw -> Muyuw
myx -> Masaaba
myy -> Macuna
mza -> Santa María Zacatepec Mixtec
mzh -> Wichí Lhamtés Güisnay
mzk -> Nigeria Mambila
mzl -> Mazatlán Mixe
mzm -> Mumuye
mzn -> Mazanderani
mzw -> Deg
mzz -> Maiadomu
nab -> Southern Nambikuára
naf -> Nabak
nah
nak -> Nakanai
nan -> Min Nan Chinese
nap -> Neapolitan
naq -> Khoekhoe
nas -> Naasioi
nav -> Navajo
naw -> Nawuri
nba -> Nyemba
nbc -> Chang Naga
nbe -> Konyak Naga
nbl -> South Ndebele
nbq -> Nggem
nbu -> Rongmei Naga
nca -> Iyo
nch -> Central Huasteca Nahuatl
ncj -> Northern Puebla Nahuatl
ncl -> Michoacán Nahuatl
ncq -> Northern Katang
nct -> Chothe Naga
ncu -> Chumburung
ncx -> Central Puebla Nahuatl
ndc -> Ndau
nde -> North Ndebele
ndh -> Ndali
ndi -> Samba Leko
ndj -> Ndamba
ndo -> Ndonga
ndp -> Ndo
nds -> Low German
ndy -> Lutos
ndz -> Ndogo
neb -> Toura (Côte d'Ivoire)
nep -> Nepali (macrolanguage)
new -> Newari
nfa -> Dhao
nfr -> Nafaanra
ngb -> Northern Ngbandi
ngc -> Ngombe (Democratic Republic of Congo)
ngl -> Lomwe
ngp -> Ngulu
ngu -> Guerrero Nahuatl
nhd -> Chiripá
nhe -> Eastern Huasteca Nahuatl
nhg -> Tetelcingo Nahuatl
nhi -> Zacatlán-Ahuacatlán-Tepetzintla Nahuatl
nhk -> Isthmus-Cosoleacaque Nahuatl
nho -> Takuu
nhr -> Naro
nhu -> Noone
nhw -> Western Huasteca Nahuatl
nhx -> Isthmus-Mecayapan Nahuatl
nhy -> Northern Oaxaca Nahuatl
nia -> Nias
nif -> Nek
nii -> Nii
nij -> Ngaju
nim -> Nilamba
nin -> Ninzo
nio -> Nganasan
niq -> Nandi
niu -> Niuean
niy -> Ngiti
njb -> Nocte Naga
njm -> Angami Naga
njn -> Liangmai Naga
njo -> Ao Naga
njz -> Nyishi
nkf -> Inpui Naga
nki -> Thangal Naga
nko -> Nkonya
nla -> Ngombale
nlc -> Nalca
nld -> Dutch
nlg -> Gela
nlx -> Nahali
nma -> Maram Naga
nmf -> Tangkhul Naga (India)
nmh -> Monsang Naga
nmo -> Moyon Naga
nmw -> Nimoa
nmz -> Nawdm
nnb -> Nande
nng -> Maring Naga
nnh -> Ngiemboon
nnl -> Northern Rengma Naga
nno -> Norwegian Nynorsk
nnp -> Wancho Naga
nnq -> Ngindo
nnw -> Southern Nuni
noa -> Woun Meu
nob -> Norwegian Bokmål
nod -> Northern Thai
noe -> Nimadi
nog -> Nogai
non -> Old Norse
nop -> Numanggang
not -> Nomatsiguenga
nou -> Ewage-Notu
nov -> Novial
nph -> Phom Naga
npi -> Nepali (individual language)
npl -> Southeastern Puebla Nahuatl
npo -> Pochuri Naga
npy -> Napu
nqo -> N'Ko
nre -> Southern Rengma Naga
nrf -> Jèrriais
nri -> Chokri Naga
nrm -> Narom
nsa -> Sangtam Naga
nse -> Nsenga
nsm -> Sumi Naga
nsn -> Nehan
nso -> Pedi
nss -> Nali
nst -> Tase Naga
nsu -> Sierra Negra Nahuatl
ntp -> Northern Tepehuan
ntr -> Delo
ntu -> Natügu
nuj -> Nyole
nus -> Nuer
nuy -> Nunggubuyu
nuz -> Tlamacazapa Nahuatl
nvm -> Namiae
nwb -> Nyabwa
nwi -> Southwest Tanna
nwx -> Middle Newar
nxd -> Ngando (Democratic Republic of Congo)
nya -> Nyanja
nyf -> Giryama
nyk -> Nyaneka
nyn -> Nyankole
nyo -> Nyoro
nyu -> Nyungwe
nyy -> Nyakyusa-Ngonde
nza -> Tigon Mbembe
nzi -> Nzima
nzm -> Zeme Naga
oar -> Old Aramaic (up to 700 BCE)
obo -> Obo Manobo
oci -> Occitan (post 1500)
ogo -> Khana
ojb -> Northwestern Ojibwa
oke -> Okpe (Southwestern Edo)
oku -> Oku
okv -> Orokaiva
old -> Mochi
olo -> Livvi
omb -> East Ambae
omw -> South Tairora
ong -> Olo
ons -> Ono
ood -> Tohono O'odham
opm -> Oksapmin
ori -> Oriya (macrolanguage)
orv -> Old Russian
ory -> Odia
oss -> Ossetian
ota -> Ottoman Turkish (1500-1928)
otd -> Ot Danum
ote -> Mezquital Otomi
otk -> Old Turkish
otm -> Eastern Highland Otomi
otn -> Tenango Otomi
oto
otq -> Querétaro Otomi
ots -> Estado de México Otomi
otw -> Ottawa
oym -> Wayampi
ozm -> Koonzime
pab -> Parecís
pad -> Paumarí
pag -> Pangasinan
pah -> Tenharim
pam -> Pampanga
pan -> Panjabi
pao -> Northern Paiute
pap -> Papiamento
pau -> Palauan
pbb -> Páez
pbc -> Patamona
pbi -> Parkwa
pbt -> Southern Pashto
pcd -> Picard
pck -> Paite Chin
pcm -> Nigerian Pidgin
pdc -> Pennsylvania German
pdt -> Plautdietsch
peg -> Pengo
pem -> Phende
pes -> Iranian Persian
pfe -> Pere
pfl -> Pfaelzisch
phm -> Phimbi
phn -> Phoenician
pib -> Yine
pio -> Piapoco
pir -> Piratapuyo
pis -> Pijin
pjt -> Pitjantjatjara
pkb -> Pokomo
plg -> Pilagá
pli -> Pali
pls -> San Marcos Tlacoyalco Popoloca
plt -> Plateau Malagasy
plu -> Palikúr
plw -> Brooke's Point Palawano
pma -> Paama
pmf -> Pamona
pmq -> Northern Pame
pms -> Piemontese
pmx -> Poumei Naga
pnb -> Western Panjabi
pne -> Western Penan
pnt -> Pontic
pny -> Pinyin
poe -> San Juan Atzingo Popoloca
poh -> Poqomchi'
poi -> Highland Popoluca
pol -> Polish
pon -> Pohnpeian
por -> Portuguese
pos -> Sayula Popoluca
pot -> Potawatomi
pov -> Upper Guinea Crioulo
poy -> Pogolo
ppk -> Uma
ppo -> Folopa
pps -> San Luís Temalacayuca Popoloca
prf -> Paranan
prg -> Prussian
pri -> Paicî
prq -> Ashéninka Perené
pse -> Central Malay
pss -> Kaulong
ptp -> Patep
ptu -> Bambam
pua -> Western Highland Purepecha
pui -> Puinave
pus -> Pushto
pwg -> Gapapaiwa
pwn -> Paiwan
pww -> Pwo Northern Karen
pxm -> Quetzaltepec Mixe
qub -> Huallaga Huánuco Quechua
quc -> K'iche'
que -> Quechua
quf -> Lambayeque Quechua
qug -> Chimborazo Highland Quichua
quh -> South Bolivian Quechua
qul -> North Bolivian Quechua
qup -> Southern Pastaza Quechua
qus -> Santiago del Estero Quichua
quw -> Tena Lowland Quichua
quy -> Ayacucho Quechua
quz -> Cusco Quechua
qva -> Ambo-Pasco Quechua
qvc -> Cajamarca Quechua
qve -> Eastern Apurímac Quechua
qvh -> Huamalíes-Dos de Mayo Huánuco Quechua
qvi -> Imbabura Highland Quichua
qvm -> Margos-Yarowilca-Lauricocha Quechua
qvn -> North Junín Quechua
qvo -> Napo Lowland Quechua
qvs -> San Martín Quechua
qvw -> Huaylla Wanca Quechua
qvz -> Northern Pastaza Quichua
qwh -> Huaylas Ancash Quechua
qxh -> Panao Huánuco Quechua
qxl -> Salasaca Highland Quichua
qxn -> Northern Conchucos Ancash Quechua
qxo -> Southern Conchucos Ancash Quechua
qxq -> Qashqa'i
qxr -> Cañar Highland Quichua
rad -> Rade
rai -> Ramoaaina
rap -> Rapanui
rar -> Rarotongan
rav -> Sampang
raw -> Rawang
rcf -> Réunion Creole French
rej -> Rejang
rel -> Rendille
rgu -> Ringgou
rhg -> Rohingya
ria -> Riang (India)
rim -> Nyaturu
rjs -> Rajbanshi
rkb -> Rikbaktsa
rmc -> Carpathian Romani
rme -> Angloromani
rml -> Baltic Romani
rmn -> Balkan Romani
rmo -> Sinte Romani
rmq -> Caló
rmy -> Vlax Romani
rnd -> Ruund
rng -> Ronga
rnl -> Ranglong
roh -> Romansh
rom -> Romany
ron -> Romanian
roo -> Rotokas
rop -> Kriol
row -> Dela-Oenale
rro -> Waima
rsk -> Ruthenian
rtm -> Rotuman
rub -> Gungu
rue -> Rusyn
ruf -> Luguru
rug -> Roviana
run -> Rundi
rup -> Macedo-Romanian
rus -> Russian
rwo -> Rawa
ryu -> Central Okinawan
sab -> Buglere
sag -> Sango
sah -> Yakut
saj -> Sahu
san -> Sanskrit
sas -> Sasak
sat -> Santali
say -> Saya
sba -> Ngambay
sbd -> Southern Samo
sbe -> Saliba
sbl -> Botolan Sambal
sbs -> Subiya
sby -> Soli
sck -> Sadri
scl -> Shina
scn -> Sicilian
sco -> Scots
sda -> Toraja-Sa'dan
sdc -> Sassarese Sardinian
sdh -> Southern Kurdish
sdo -> Bukar-Sadung Bidayuh
sdq -> Semandang
seh -> Sena
sel -> Selkup
ses -> Koyraboro Senni Songhai
sey -> Secoya
sfw -> Sehwi
sgb -> Mag-antsi Ayta
sgc -> Kipsigis
sgh -> Shughni
sgj -> Surgujia
sgs -> Samogitian
sgw -> Sebat Bet Gurage
sgz -> Sursurunga
shi -> Tachelhit
shk -> Shilluk
shn -> Shan
shp -> Shipibo-Conibo
shr -> Shi
shu -> Chadian Arabic
shy -> Tachawit
sid -> Sidamo
sig -> Paasaal
sil -> Tumulung Sisaala
sim -> Mende (Papua New Guinea)
sin -> Sinhala
sja -> Epena
sjo -> Xibe
sjp -> Surjapuri
sju -> Ume Sami
skg -> Sakalava Malagasy
skr -> Saraiki
sld -> Sissala
slk -> Slovak
sll -> Salt-Yui
slv -> Slovenian
sma -> Southern Sami
sme -> Northern Sami
smj -> Lule Sami
smk -> Bolinao
sml -> Central Sama
smn -> Inari Sami
smo -> Samoan
sms -> Skolt Sami
smt -> Simte
sna -> Shona
snc -> Sinaugoro
snd -> Sindhi
snf -> Noon
snn -> Siona
snp -> Siane
snw -> Selee
sny -> Saniyo-Hiyewe
soe -> Songomeno
som -> Somali
sop -> Songe
soq -> Kanasi
sot -> Southern Sotho
soy -> Miyobe
spa -> Spanish
spl -> Selepet
spm -> Akukem
spp -> Supyire Senoufo
sps -> Saposa
spv -> Sambalpuri
spy -> Sabaot
srd -> Sardinian
sri -> Siriano
srm -> Saramaccan
srn -> Sranan Tongo
srp -> Serbian
srq -> Sirionó
srr -> Serer
ssd -> Siroi
ssg -> Seimat
ssw -> Swati
ssx -> Samberigi
stn -> Owa
stp -> Southeastern Tepehuan
stq -> Saterfriesisch
sua -> Sulka
suc -> Western Subanon
sue -> Suena
suk -> Sukuma
sun -> Sundanese
sur -> Mwaghavul
sus -> Susu
sux -> Sumerian
suz -> Sunwar
sva -> Svan
swb -> Maore Comorian
swc -> Congo Swahili
swe -> Swedish
swg -> Swabian
swh -> Swahili (individual language)
swk -> Malawi Sena
swp -> Suau
sxb -> Suba
sxn -> Sangir
syb -> Central Subanen
syc -> Classical Syriac
syl -> Sylheti
szb -> Ngalum
szl -> Silesian
szy -> Sakizaya
tab -> Tabassaran
tac -> Lowland Tarahumara
tah -> Tahitian
taj -> Eastern Tamang
tam -> Tamil
tap -> Taabwa
taq -> Tamasheq
tar -> Central Tarahumara
tat -> Tatar
tav -> Tatuyo
taw -> Tai
tay -> Atayal
tbc -> Takia
tbg -> North Tairora
tbk -> Calamian Tagbanwa
tbl -> Tboli
tbo -> Tawala
tbw -> Tagbanwa
tby -> Tabaru
tbz -> Ditammari
tca -> Ticuna
tcc -> Datooga
tcf -> Malinaltepec Me'phaa
tcs -> Torres Strait Creole
tcy -> Tulu
tcz -> Thado Chin
tdd -> Tai Nüa
tdt -> Tetun Dili
tdx -> Tandroy-Mahafaly Malagasy
ted -> Tepo Krumen
tee -> Huehuetla Tepehua
tel -> Telugu
tem -> Timne
teo -> Teso
ter -> Tereno
tet -> Tetum
tew -> Tewa (USA)
tfr -> Teribe
tgk -> Tajik
tgl -> Tagalog
tgo -> Sudest
tgp -> Tangoa
tha -> Thai
thk -> Tharaka
thl -> Dangaura Tharu
thv -> Tahaggart Tamahaq
tif -> Tifal
tig -> Tigre
tih -> Timugon Murut
tik -> Tikar
tim -> Timbe
tir -> Tigrinya
tiv -> Tiv
tiy -> Tiruray
tke -> Takwane
tkl -> Tokelau
tkr -> Tsakhur
tku -> Upper Necaxa Totonac
tlb -> Tobelo
tlf -> Telefol
tlh -> Klingon
tlj -> Talinga-Bwisi
tll -> Tetela
tly -> Talysh
tmc -> Tumak
tmd -> Haruai
tmr -> Jewish Babylonian Aramaic (ca. 200-1200 CE)
tna -> Tacana
tnc -> Tanimuca-Retuarã
tnk -> Kwamera
tnn -> North Tanna
tnp -> Whitesands
tnr -> Ménik
tob -> Toba
toc -> Coyutla Totonac
tod -> Toma
tog -> Tonga (Nyasa)
toh -> Gitonga
toi -> Tonga (Zambia)
toj -> Tojolabal
tok -> Toki Pona
ton -> Tonga (Tonga Islands)
too -> Xicotepec De Juárez Totonac
top -> Papantla Totonac
tos -> Highland Totonac
tpa -> Taupota
tpi -> Tok Pisin
tpm -> Tampulma
tpn -> Tupinambá
tpp -> Pisaflores Tepehua
tpt -> Tlachichilco Tepehua
tpw -> Tupí
tpz -> Tinputz
tqo -> Toaripi
trc -> Copala Triqui
trn -> Trinitario
tro -> Tarao Naga
trp -> Kok Borok
trq -> San Martín Itunyoso Triqui
trs -> Chicahuaxtla Triqui
trv -> Sediq
tsc -> Tswa
tsg -> Tausug
tsn -> Tswana
tso -> Tsonga
tsw -> Tsishingini
tsz -> Purepecha
ttc -> Tektiteko
tte -> Bwanabwana
ttj -> Tooro
ttq -> Tawallammat Tamajaq
tts -> Northeastern Thai
tuc -> Mutu
tue -> Tuyuca
tuf -> Central Tunebo
tui -> Tupuri
tuk -> Turkmen
tul -> Tula
tum -> Tumbuka
tuo -> Tucano
tur -> Turkish
tuv -> Turkana
tvk -> Southeast Ambrym
tvl -> Tuvalu
twb -> Western Tawbuid
twi -> Twi
twu -> Termanu
twx -> Tewe
txq -> Tii
txu -> Kayapó
tyv -> Tuvinian
tzh -> Tzeltal
tzj -> Tz'utujil
tzl -> Talossan
tzm -> Central Atlas Tamazight
tzo -> Tzotzil
ubr -> Ubir
ubu -> Umbu-Ungu
udm -> Udmurt
udu -> Uduk
uig -> Uighur
ukr -> Ukrainian
umb -> Umbundu
und -> Undetermined
unr -> Mundari
unx -> Munda
upv -> Uripiv-Wala-Rano-Atchin
ura -> Urarina
urb -> Urubú-Kaapor
urd -> Urdu
urh -> Urhobo
uri -> Urim
urk -> Urak Lawoi'
urt -> Urat
urw -> Sop
ury -> Orya
usa -> Usarufa
usp -> Uspanteco
uth -> ut-Hun
uvh -> Uri
uvl -> Lote
uzn -> Northern Uzbek
uzs -> Southern Uzbek
vag -> Vagla
vap -> Vaiphei
var -> Huarijio
vec -> Venetian
ven -> Venda
vep -> Veps
vid -> Vidunda
vie -> Vietnamese
viv -> Iduna
vls -> Vlaams
vmk -> Makhuwa-Shirima
vmw -> Makhuwa
vmy -> Ayautla Mazatec
vol -> Volapük
vot -> Votic
vro -> Võro
vun -> Vunjo
vut -> Vute
waj -> Waffa
wal -> Wolaytta
wap -> Wapishana
war -> Waray (Philippines)
wat -> Kaninuwa
way -> Wayana
wba -> Warao
wbm -> Wa
wbp -> Warlpiri
wbr -> Wagdi
wed -> Wedau
wer -> Weri
wes -> Cameroon Pidgin
wew -> Wejewa
whg -> North Wahgi
whk -> Wahau Kenyah
wib -> Southern Toussian
wim -> Wik-Mungkan
wiu -> Wiru
wln -> Walloon
wls -> Wallisian
wlv -> Wichí Lhamtés Vejoz
wlx -> Wali (Ghana)
wmt -> Walmajarri
wmw -> Mwani
wnc -> Wantoat
wnu -> Usan
wob -> Wè Northern
wol -> Wolof
wos -> Hanga Hundi
wrk -> Garrwa
wrs -> Waris
wsg -> Adilabad Gondi
wsk -> Waskia
wuu -> Wu Chinese
wuv -> Wuvulu-Aua
wwa -> Waama
xal -> Kalmyk
xav -> Xavánte
xbi -> Kombio
xbr -> Kambera
xed -> Hdi
xho -> Xhosa
xla -> Kamula
xmf -> Mingrelian
xmm -> Manado Malay
xmv -> Antankarana Malagasy
xnn -> Northern Kankanay
xnr -> Kangri
xog -> Soga
xon -> Konkomba
xqa -> Karakhanid
xrb -> Eastern Karaboro
xsb -> Sambal
xsi -> Sio
xsm -> Kasem
xsr -> Sherpa
xsu -> Sanumá
xtd -> Diuxi-Tilantongo Mixtec
xtm -> Magdalena Peñasco Mixtec
xtn -> Northern Tlaxiaco Mixtec
xum -> Umbrian
xuo -> Kuo
yaa -> Yaminahua
yad -> Yagua
yal -> Yalunka
yam -> Yamba
yan -> Mayangna
yao -> Yao
yap -> Yapese
yaq -> Yaqui
yas -> Nugunu (Cameroon)
yat -> Yambeta
yaz -> Lokaa
ybb -> Yemba
yby -> Yaweyuha
ycn -> Yucuna
ydd -> Eastern Yiddish
yid -> Yiddish
yim -> Yimchungru Naga
yka -> Yakan
yle -> Yele
yli -> Angguruk Yali
yml -> Iamalele
yom -> Yombe
yon -> Yongkom
yor -> Yoruba
yrb -> Yareba
yre -> Yaouré
yrk -> Nenets
yrl -> Nhengatu
yss -> Yessan-Mayo
yua -> Yucateco
yue -> Yue Chinese
yuj -> Karkar-Yuri
yup -> Yukpa
yut -> Yopno
yuw -> Yau (Morobe Province)
yuz -> Yuracare
yva -> Yawa
zaa -> Sierra de Juárez Zapotec
zab -> Western Tlacolula Valley Zapotec
zac -> Ocotlán Zapotec
zad -> Cajonos Zapotec
zae -> Yareni Zapotec
zai -> Isthmus Zapotec
zam -> Miahuatlán Zapotec
zao -> Ozolotepec Zapotec
zar -> Rincón Zapotec
zas -> Santo Domingo Albarradas Zapotec
zat -> Tabaa Zapotec
zav -> Yatzachi Zapotec
zaw -> Mitla Zapotec
zca -> Coatecas Altas Zapotec
zdj -> Ngazidja Comorian
zea -> Zeeuws
zgh -> Standard Moroccan Tamazight
zho -> Chinese
zia -> Zia
ziw -> Zigula
zlm -> Malay (individual language)
zne -> Zande (individual language)
zoc -> Copainalá Zoque
zom -> Zou
zos -> Francisco León Zoque
zpa -> Lachiguiri Zapotec
zpc -> Choapan Zapotec
zpg -> Guevea De Humboldt Zapotec
zpi -> Santa María Quiegolani Zapotec
zpj -> Quiavicuzas Zapotec
zpl -> Lachixío Zapotec
zpm -> Mixtepec Zapotec
zpo -> Amatlán Zapotec
zpq -> Zoogocho Zapotec
zpt -> San Vicente Coatlán Zapotec
zpu -> Yalálag Zapotec
zpv -> Chichicapan Zapotec
zpz -> Texmelucan Zapotec
zsm -> Standard Malay
zsr -> Southern Rincon Zapotec
ztq -> Quioquitani-Quierí Zapotec
zty -> Yatee Zapotec
zul -> Zulu
zxx -> No linguistic content
zyb -> Yongbei Zhuang
zyp -> Zyphe Chin